**************************
*........................*
*.*******.*******.******.*
*.*.......*.......*......*
*.*.*************.******.*
*.*.*.......*.....*......*
*.*.*******.*.**********.*
*.*...........*..........*
*.**********************.*
*........................*
*.**********************.*
*.*......................*
*.*.********************.*
*.*......................*
*.*********************..*
*........................*
**************************
